##   B ###
## #### ##
##      ##
####### ##
#A##    ##
# ###   ##
#       ##
##########